--------------------------------
-..............................-
-..............................-
-..............................-
-......-................-......-
-..............................-
-..............................-
-..............................-
-..............................-
-..............................-
-......-................-......-
-..............................-
-..............................-
-..............................-
-..............................-
--------------------------------